##########
..##@#.####
.##..###..#
##........#
#......#..#
#.....##..#
#.#..#....#
###.##.#.##
##......###
##.....####
###########